###############################################
#                                             #
#   ###     ..   ..                           #
#    #     .... ....                          #
#    #     .........                          #
#    #      .......                           #
#    #        ...                             #
#   ###        .      #   #   #####   ###     #
#                     ##  #   #        #      #
#                     # # #   #####    #      #
#                     #  ##       #    #      #
#                     #   #   #####   ###     #
#                     ...................     #
#                                             #
###############################################
