###############################################
#                                             #
#        .. ...                               #
#        ... .......          #######         #
#        .. ...               #     #         #
#                       #######     #         #
#                           #####  ####       #
#                                             #
#                             .......         #
#                                ..           #
#                                ..           #
#                                ..           #
#                                             #
#                                             #
###############################################
