#######
# ... #
# .#  #
#     #
#######
