#######################
#                     #
#        .....        #
#    ...   .  ###     #
#    .#       #       #
#             #####   #
#         ...         #
#          .          #
#######################
